1 1 1 1 1 1 1 1 1 1 1
-1 1 1 1 1 1 1 1 1 1 1
1 1 1 1 1 1 1 1 1 1 1
-2 2 2 6 2 5 2 2 2 2 2
1 3 6 6 3 4 5 3 4 5 0
-6 6 6 6 6 6 6 6 6 6 6
0 4 6 6 6 4 4 4 4 4 4
0 0 0 0 0 0 0 0 0 0 0
0 0 0 0 0 0 0 0 0 0 0
0 0 0 0 0 0 0 0 0 0 0
0 0 0 0 0 0 0 0 0 0 0
0 0 0 0 0 0 0 0 0 0 0
0 0 0 0 0 0 0 0 0 0 0
0 0 0 0 0 0 0 0 0 0 0